111111111111111111111111111
1  1 1 1 1 1 1 1 1 1 1 1 11
1             P          11
1                        11
1      1 1 1 1 1 1 1 1 1 11
1      11111111111111111 11
1      1               1 11
1      11   1     1   11 11
1      1               1 11
1      11   1     1   11 11
1      1               1 11
1      11   1  P  1   11 11
1      1               1 11
1      11   1     1   11 11
1      1               1 11
1      11   1  P  1   11 11
1      1               1 11
1      11             11 11
1      11111111P11111111 11
1       1111         111 11
1  1111 1            111 11
1  1    1              1 11
1  1    1              1 11
1  111111              1 11
1                        11
111111111111111111111111111
