111111111111111111111
1P    1     1       1
1111  1  1  1  111  1
1  1     1     111111
1  1111111  111111111
1           111  1111
1111  1111  111  1111
1     1         P   1
1  1  1111  111  1111
1  1  1     111  1111
111111111111111111111